10.ox
....o...o.
..........
.......oo.
.....oo...
....o.o.o.
.......ooo
..o...o...
...o......
..o..o....
.....o.o..