10.ox
.o.o.o.o..
.....o..o.
o..ooooooo
....oo....
o.o....o.o
oo....oo..
o...oo..o.
........oo
.o.o..oo.o
.o..ooooo.